###################
#.       @        #
#  #          #   #
#  .  #  #  #     #
#                 #
#       #.#       #
#                 #
#         $$$     #
#                 #
#                 #
#                 #
###################