##########
#@       #
#### #####
#        #
#        #
#   .#   #
#   ##   #
#    # $ #
#    #   #
##########